SO ./textures/BRICK_WALL.xpm
NO       ./textures/PLANT_WALL.xpm
WE ./textures/STONE_WALL2.xpm
EA       ./textures/WOOD_WALL.xpm

F       220,100,0
C 0,30,200

        1111111111111111111111111
        1000000000110000000000001
        101100N001110000000000001
        1001000000000000111111111
1111111110110000011100001
1000000000110000011101111
1111011111111101110000001
1111011111111101110101001
1100000011010101110000001
1000000000000000110000001
1000000000000000110101001
11000001110101011111011111
11110111 1110101  10111101
11111111 1111111  11111111